SSSSSXSSSSSS
SXXXXXSSSSSS
SXXXSXXSXYSS
SXXXXXSRSXBY
SXXTXXRXXXSS
SXXTXXSSSXSS
SXXTXXSSXXYS
SSSYSSSSSSSS