XXXSXXXXXSXX
XXXSXBXXYSXX
XXXSTXXXXSXX
XXXSYXXRXSXX
XXXSXXXXXSXX
XXXSXXXXXSXX
XXXSXXXXXSXX
XXXSXXXXXSXX